FFFFFFPF
FWWWWFFX
FWFWFPFW
FWPWFFFW
FFFPFFFP