FFFXFFPWWF
FPWWFFWFFF
FWFFFXFFFF
FPWWFFPWWF
FFFFFFFFFF
