FFFFPFFW
FWWWWFFF
FWFWFFFW
FWFFFFFW
FFFFFFWW
WFWFWFWF